type octile
height 2
width 5
map
.....
@@.@@